F 220,100,0

SO ./img/rock.png
NO ./img/plank.png
WE ./img/wood.png
EA ./img/brick.png
C 225,30,0






        1111 111111 1111111 1111
        1111111111111111111111111
        1000000000110000000000001111
        1011000001110000000000001
       11001000000000000000000001
111111111000001110000000000001111
1000000000110000011101111111111111
11110111111111011100000010001
11110111111111011101010010001
11000000110101011111100010001111111
100000000110000001  100000001000010111
10000000000E00001111110010001111111
111111111110011111111111111111
110000011101010111110111100111
11110111 11101011101111010001
11111111 1111111 111111111111