F 0,0,0

SO ./img/rock.png
NO ./img/plank.png
WE ./img/wood.png
EA ./img/brick.png
C 255,  0,  0

1111111111111
111100000001
1000000000001111111
10000000000000000N01
1000000000001111111
1000000000001
1000000000001
10000000000001 
1000000000001
1000000000001
1000000000001
1111111111111
