


F 220,00,0


SO ./img/rock.png
NO ./img/plank.png
WE ./img/wood.png
EA ./img/brick.png


C 255,255,25







        1111 111111 1111111 1111
        1111111111111111111111111
        1000000000110000000000001111
     1110001000001110000000000001111
    11001000000000000000000000001
111111111000001110000000E000011101111
100000000011000001110111111111111
11110111111111011100000010001        
1111011111111101110101001000011
11000000110101011111100010001111111
100000000110000001  100000001000011111
10000000000000001111110010001111111
111111111110011111111111111111111
11000001110101011111011110011101111111
1111011111110101101111010001111                111
11111111 1111111 111111111111           
1